"prov_or_terr","health_region","date","cases","cum_cases","time_since_first"
"Manitoba","Winnipeg",2020-03-12,1,1,0
"Manitoba","Winnipeg",2020-03-13,3,4,1
"Manitoba","Winnipeg",2020-03-15,2,6,3
"Manitoba","Winnipeg",2020-03-16,1,7,4
"Manitoba","Winnipeg",2020-03-17,5,12,5
"Manitoba","Winnipeg",2020-03-18,2,14,6
"Manitoba","Winnipeg",2020-03-21,2,16,9
"Manitoba","Winnipeg",2020-03-23,1,17,11
"Manitoba","Winnipeg",2020-03-24,1,18,12
"Manitoba","Winnipeg",2020-03-25,11,29,13
"Manitoba","Winnipeg",2020-03-26,1,30,14
"Manitoba","Winnipeg",2020-03-27,1,31,15
"Manitoba","Winnipeg",2020-03-28,25,56,16
"Manitoba","Winnipeg",2020-03-29,4,60,17
"Manitoba","Winnipeg",2020-03-30,18,78,18
"Manitoba","Winnipeg",2020-03-31,6,84,19
"Manitoba","Winnipeg",2020-04-01,20,104,20
"Manitoba","Winnipeg",2020-04-02,27,131,21
"Manitoba","Winnipeg",2020-04-03,13,144,22
"Manitoba","Winnipeg",2020-04-04,8,152,23
"Manitoba","Winnipeg",2020-04-05,5,157,24
"Manitoba","Winnipeg",2020-04-06,1,158,25
"Manitoba","Winnipeg",2020-04-07,11,169,26
"Manitoba","Winnipeg",2020-04-08,1,170,27
"Manitoba","Winnipeg",2020-04-09,2,172,28
"Manitoba","Winnipeg",2020-04-10,4,176,29
"Manitoba","Winnipeg",2020-04-11,9,185,30
"Manitoba","Winnipeg",2020-04-13,1,186,32
"Manitoba","Winnipeg",2020-04-15,1,187,34
"Manitoba","Winnipeg",2020-04-16,3,190,35
"Manitoba","Winnipeg",2020-04-18,2,192,37
"Manitoba","Winnipeg",2020-04-20,1,193,39
"Manitoba","Winnipeg",2020-04-21,1,194,40
"Manitoba","Winnipeg",2020-04-22,1,195,41
"Manitoba","Winnipeg",2020-04-23,5,200,42
"Manitoba","Winnipeg",2020-04-25,2,202,44
"Manitoba","Winnipeg",2020-04-26,3,205,45
"Manitoba","Winnipeg",2020-04-27,1,206,46
"Manitoba","Winnipeg",2020-04-30,2,208,49
"Manitoba","Winnipeg",2020-05-01,1,209,50
"Manitoba","Winnipeg",2020-05-10,1,210,59
"Manitoba","Winnipeg",2020-05-18,1,211,67
"Manitoba","Winnipeg",2020-05-22,2,213,71
"Manitoba","Winnipeg",2020-05-28,2,215,77
"Manitoba","Winnipeg",2020-06-05,2,217,85
"Manitoba","Winnipeg",2020-06-12,1,218,92
"Manitoba","Winnipeg",2020-06-13,2,220,93
"Manitoba","Winnipeg",2020-06-14,1,221,94
"Manitoba","Winnipeg",2020-06-17,2,223,97
"Manitoba","Winnipeg",2020-06-18,2,225,98
"Manitoba","Winnipeg",2020-06-19,1,226,99
"Manitoba","Winnipeg",2020-06-20,1,227,100
"Manitoba","Winnipeg",2020-06-24,1,228,104
"Manitoba","Winnipeg",2020-06-26,2,230,106
"Manitoba","Winnipeg",2020-06-27,3,233,107
"Manitoba","Winnipeg",2020-06-29,2,235,109
"Manitoba","Winnipeg",2020-06-30,1,236,110
"Manitoba","Winnipeg",2020-07-14,2,238,124
"Manitoba","Winnipeg",2020-07-20,3,241,130
"Manitoba","Winnipeg",2020-07-21,2,243,131
"Manitoba","Winnipeg",2020-07-22,1,244,132
"Manitoba","Winnipeg",2020-07-24,1,245,134
"Manitoba","Winnipeg",2020-07-27,3,248,137
"Manitoba","Winnipeg",2020-07-28,1,249,138
"Manitoba","Winnipeg",2020-07-29,1,250,139
"Manitoba","Winnipeg",2020-07-31,1,251,141
"Manitoba","Winnipeg",2020-08-04,3,254,145
"Manitoba","Winnipeg",2020-08-05,2,256,146
"Manitoba","Winnipeg",2020-08-06,1,257,147
"Manitoba","Winnipeg",2020-08-07,5,262,148
"Manitoba","Winnipeg",2020-08-09,4,266,150
"Manitoba","Winnipeg",2020-08-11,1,267,152
"Manitoba","Winnipeg",2020-08-12,10,277,153
"Manitoba","Winnipeg",2020-08-13,7,284,154
"Manitoba","Winnipeg",2020-08-14,10,294,155
"Manitoba","Winnipeg",2020-08-15,10,304,156
"Manitoba","Winnipeg",2020-08-16,6,310,157
"Manitoba","Winnipeg",2020-08-17,1,311,158
"Manitoba","Winnipeg",2020-08-18,11,322,159
"Manitoba","Winnipeg",2020-08-20,6,328,161
"Manitoba","Winnipeg",2020-08-21,7,335,162
"Manitoba","Winnipeg",2020-08-22,2,337,163
"Manitoba","Winnipeg",2020-08-23,9,346,164
"Manitoba","Winnipeg",2020-08-24,8,354,165
"Manitoba","Winnipeg",2020-08-25,6,360,166
"Manitoba","Winnipeg",2020-08-26,9,369,167
"Manitoba","Winnipeg",2020-08-27,4,373,168
"Manitoba","Winnipeg",2020-08-28,8,381,169
"Manitoba","Winnipeg",2020-08-29,19,400,170
"Manitoba","Winnipeg",2020-08-30,17,417,171
"Manitoba","Winnipeg",2020-08-31,4,421,172
"Manitoba","Winnipeg",2020-09-01,9,430,173
"Manitoba","Winnipeg",2020-09-02,5,435,174
"Manitoba","Winnipeg",2020-09-03,13,448,175
"Manitoba","Winnipeg",2020-09-04,6,454,176
"Manitoba","Winnipeg",2020-09-05,10,464,177
"Manitoba","Winnipeg",2020-09-06,17,481,178
"Manitoba","Winnipeg",2020-09-07,7,488,179
"Manitoba","Winnipeg",2020-09-08,8,496,180
"Manitoba","Winnipeg",2020-09-09,14,510,181
"Manitoba","Winnipeg",2020-09-10,9,519,182
"Manitoba","Winnipeg",2020-09-11,8,527,183
"Manitoba","Winnipeg",2020-09-12,8,535,184
"Manitoba","Winnipeg",2020-09-13,12,547,185
"Manitoba","Winnipeg",2020-09-14,17,564,186
"Manitoba","Winnipeg",2020-09-15,13,577,187
"Manitoba","Winnipeg",2020-09-16,21,598,188
"Manitoba","Winnipeg",2020-09-17,8,606,189
"Manitoba","Winnipeg",2020-09-18,29,635,190
"Manitoba","Winnipeg",2020-09-19,13,648,191
"Manitoba","Winnipeg",2020-09-20,23,671,192
"Manitoba","Winnipeg",2020-09-21,17,688,193
"Manitoba","Winnipeg",2020-09-22,20,708,194
"Manitoba","Winnipeg",2020-09-23,30,738,195
"Manitoba","Winnipeg",2020-09-24,29,767,196
"Manitoba","Winnipeg",2020-09-25,47,814,197
"Manitoba","Winnipeg",2020-09-26,56,870,198
"Manitoba","Winnipeg",2020-09-27,36,906,199
"Manitoba","Winnipeg",2020-09-28,22,928,200
"Manitoba","Winnipeg",2020-09-29,26,954,201
"Manitoba","Winnipeg",2020-09-30,31,985,202
"Manitoba","Winnipeg",2020-10-01,28,1013,203
"Manitoba","Winnipeg",2020-10-02,29,1042,204
"Manitoba","Winnipeg",2020-10-03,32,1074,205
"Manitoba","Winnipeg",2020-10-04,23,1097,206
"Manitoba","Winnipeg",2020-10-05,36,1133,207
"Manitoba","Winnipeg",2020-10-06,31,1164,208
"Manitoba","Winnipeg",2020-10-07,21,1185,209
"Manitoba","Winnipeg",2020-10-08,57,1242,210
"Manitoba","Winnipeg",2020-10-09,64,1306,211
"Manitoba","Winnipeg",2020-10-10,74,1380,212
"Manitoba","Winnipeg",2020-10-11,40,1420,213
"Manitoba","Winnipeg",2020-10-12,56,1476,214
"Manitoba","Winnipeg",2020-10-13,95,1571,215
"Manitoba","Winnipeg",2020-10-14,119,1690,216
"Manitoba","Winnipeg",2020-10-15,133,1823,217
"Manitoba","Winnipeg",2020-10-16,63,1886,218
"Manitoba","Winnipeg",2020-10-17,68,1954,219
"Manitoba","Winnipeg",2020-10-18,22,1976,220
"Manitoba","Winnipeg",2020-10-19,49,2025,221
"Manitoba","Winnipeg",2020-10-20,91,2116,222
"Manitoba","Winnipeg",2020-10-21,102,2218,223
"Manitoba","Winnipeg",2020-10-22,77,2295,224
"Manitoba","Winnipeg",2020-10-23,128,2423,225
"Manitoba","Winnipeg",2020-10-24,94,2517,226
"Manitoba","Winnipeg",2020-10-25,110,2627,227
"Manitoba","Winnipeg",2020-10-26,64,2691,228
"Manitoba","Winnipeg",2020-10-27,149,2840,229
"Manitoba","Winnipeg",2020-10-28,115,2955,230
"Manitoba","Winnipeg",2020-10-29,141,3096,231
"Manitoba","Winnipeg",2020-10-30,315,3411,232
"Manitoba","Winnipeg",2020-10-31,229,3640,233
"Manitoba","Winnipeg",2020-11-01,238,3878,234
"Manitoba","Winnipeg",2020-11-02,122,4000,235
"Manitoba","Winnipeg",2020-11-03,56,4056,236
"Manitoba","Winnipeg",2020-11-04,273,4329,237
"Manitoba","Winnipeg",2020-11-05,263,4592,238
"Manitoba","Winnipeg",2020-11-06,127,4719,239
"Manitoba","Winnipeg",2020-11-07,156,4875,240
"Manitoba","Winnipeg",2020-11-08,306,5181,241
"Manitoba","Winnipeg",2020-11-09,231,5412,242
"Manitoba","Winnipeg",2020-11-10,213,5625,243
"Manitoba","Winnipeg",2020-11-11,252,5877,244
"Manitoba","Winnipeg",2020-11-12,306,6183,245
"Manitoba","Winnipeg",2020-11-13,318,6501,246
"Manitoba","Winnipeg",2020-11-14,164,6665,247
"Manitoba","Winnipeg",2020-11-15,219,6884,248
"Manitoba","Winnipeg",2020-11-16,265,7149,249
"Manitoba","Winnipeg",2020-11-17,117,7266,250
"Manitoba","Winnipeg",2020-11-18,249,7515,251
"Manitoba","Winnipeg",2020-11-19,265,7780,252
"Manitoba","Winnipeg",2020-11-20,244,8024,253
"Manitoba","Winnipeg",2020-11-21,214,8238,254
"Manitoba","Winnipeg",2020-11-22,136,8374,255
"Manitoba","Winnipeg",2020-11-23,366,8740,256
"Manitoba","Winnipeg",2020-11-24,267,9007,257
"Manitoba","Winnipeg",2020-11-25,209,9216,258
"Manitoba","Winnipeg",2020-11-26,207,9423,259
"Manitoba","Winnipeg",2020-11-27,182,9605,260
"Manitoba","Winnipeg",2020-11-28,313,9918,261
"Manitoba","Winnipeg",2020-11-29,237,10155,262
"Manitoba","Winnipeg",2020-11-30,206,10361,263
"Manitoba","Winnipeg",2020-12-01,185,10546,264
"Manitoba","Winnipeg",2020-12-02,200,10746,265
"Manitoba","Winnipeg",2020-12-03,216,10962,266
"Manitoba","Winnipeg",2020-12-04,200,11162,267
"Manitoba","Winnipeg",2020-12-05,241,11403,268
"Manitoba","Winnipeg",2020-12-06,269,11672,269
"Manitoba","Winnipeg",2020-12-07,187,11859,270
"Manitoba","Winnipeg",2020-12-08,143,12002,271
"Manitoba","Winnipeg",2020-12-09,192,12194,272
"Manitoba","Winnipeg",2020-12-10,150,12344,273
"Manitoba","Winnipeg",2020-12-11,193,12537,274
"Manitoba","Winnipeg",2020-12-12,198,12735,275
"Manitoba","Winnipeg",2020-12-13,178,12913,276
"Manitoba","Winnipeg",2020-12-14,175,13088,277
"Manitoba","Winnipeg",2020-12-15,173,13261,278
"Manitoba","Winnipeg",2020-12-16,157,13418,279
"Manitoba","Winnipeg",2020-12-17,116,13534,280
"Manitoba","Winnipeg",2020-12-18,135,13669,281
"Manitoba","Winnipeg",2020-12-19,103,13772,282
"Manitoba","Winnipeg",2020-12-20,133,13905,283
"Manitoba","Winnipeg",2020-12-21,88,13993,284
"Manitoba","Winnipeg",2020-12-22,92,14085,285
"Manitoba","Winnipeg",2020-12-23,127,14212,286
"Manitoba","Winnipeg",2020-12-24,111,14323,287
"Manitoba","Winnipeg",2020-12-27,245,14568,290
"Manitoba","Winnipeg",2020-12-28,44,14612,291
"Manitoba","Winnipeg",2020-12-29,88,14700,292
"Manitoba","Winnipeg",2020-12-30,92,14792,293
"Manitoba","Winnipeg",2020-12-31,90,14882,294
"Manitoba","Winnipeg",2021-01-02,217,15099,296
"Manitoba","Winnipeg",2021-01-03,64,15163,297
"Manitoba","Winnipeg",2021-01-04,82,15245,298
"Manitoba","Winnipeg",2021-01-05,75,15320,299
"Manitoba","Winnipeg",2021-01-06,109,15429,300
"Manitoba","Winnipeg",2021-01-07,107,15536,301
"Manitoba","Winnipeg",2021-01-08,98,15634,302
"Manitoba","Winnipeg",2021-01-09,85,15719,303
"Manitoba","Winnipeg",2021-01-10,73,15792,304
"Manitoba","Winnipeg",2021-01-11,46,15838,305
"Manitoba","Winnipeg",2021-01-12,43,15881,306
"Manitoba","Winnipeg",2021-01-13,62,15943,307
"Manitoba","Winnipeg",2021-01-14,76,16019,308
"Manitoba","Winnipeg",2021-01-15,73,16092,309
"Manitoba","Winnipeg",2021-01-16,83,16175,310
"Manitoba","Winnipeg",2021-01-17,63,16238,311
"Manitoba","Winnipeg",2021-01-18,47,16285,312
"Manitoba","Winnipeg",2021-01-19,49,16334,313
"Manitoba","Winnipeg",2021-01-20,46,16380,314
"Manitoba","Winnipeg",2021-01-21,61,16441,315
"Manitoba","Winnipeg",2021-01-22,60,16501,316
"Manitoba","Winnipeg",2021-01-23,55,16556,317
"Manitoba","Winnipeg",2021-01-24,62,16618,318
"Manitoba","Winnipeg",2021-01-25,34,16652,319
"Manitoba","Winnipeg",2021-01-26,40,16692,320
"Manitoba","Winnipeg",2021-01-27,43,16735,321
"Manitoba","Winnipeg",2021-01-28,25,16760,322
"Manitoba","Winnipeg",2021-01-29,30,16790,323
"Manitoba","Winnipeg",2021-01-30,50,16840,324
"Manitoba","Winnipeg",2021-01-31,26,16866,325
"Manitoba","Winnipeg",2021-02-01,18,16884,326
"Manitoba","Winnipeg",2021-02-02,20,16904,327
"Manitoba","Winnipeg",2021-02-03,38,16942,328
"Manitoba","Winnipeg",2021-02-04,23,16965,329
"Manitoba","Winnipeg",2021-02-05,35,17000,330
"Manitoba","Winnipeg",2021-02-06,39,17039,331
"Manitoba","Winnipeg",2021-02-07,31,17070,332
"Manitoba","Winnipeg",2021-02-08,28,17098,333
"Manitoba","Winnipeg",2021-02-09,46,17144,334
"Manitoba","Winnipeg",2021-02-10,21,17165,335
"Manitoba","Winnipeg",2021-02-11,23,17188,336
"Manitoba","Winnipeg",2021-02-12,19,17207,337
"Manitoba","Winnipeg",2021-02-13,42,17249,338
"Manitoba","Winnipeg",2021-02-14,27,17276,339
"Manitoba","Winnipeg",2021-02-16,45,17321,341
"Manitoba","Winnipeg",2021-02-17,22,17343,342
"Manitoba","Winnipeg",2021-02-18,49,17392,343
"Manitoba","Winnipeg",2021-02-19,34,17426,344
"Manitoba","Winnipeg",2021-02-20,31,17457,345
"Manitoba","Winnipeg",2021-02-21,27,17484,346
"Manitoba","Winnipeg",2021-02-22,48,17532,347
"Manitoba","Winnipeg",2021-02-23,35,17567,348
"Manitoba","Winnipeg",2021-02-24,27,17594,349
"Manitoba","Winnipeg",2021-02-25,32,17626,350
"Manitoba","Winnipeg",2021-02-26,26,17652,351
"Manitoba","Winnipeg",2021-02-27,39,17691,352
"Manitoba","Winnipeg",2021-02-28,21,17712,353
"Manitoba","Winnipeg",2021-03-01,13,17725,354
"Manitoba","Winnipeg",2021-03-02,39,17764,355
"Manitoba","Winnipeg",2021-03-03,14,17778,356
"Manitoba","Winnipeg",2021-03-04,17,17795,357
"Manitoba","Winnipeg",2021-03-05,11,17806,358
"Manitoba","Winnipeg",2021-03-06,20,17826,359
"Manitoba","Winnipeg",2021-03-07,25,17851,360
"Manitoba","Winnipeg",2021-03-08,19,17870,361
"Manitoba","Winnipeg",2021-03-09,12,17882,362
"Manitoba","Winnipeg",2021-03-10,13,17895,363
"Manitoba","Winnipeg",2021-03-11,20,17915,364
"Manitoba","Winnipeg",2021-03-12,37,17952,365
"Manitoba","Winnipeg",2021-03-13,30,17982,366
"Manitoba","Winnipeg",2021-03-14,26,18008,367
"Manitoba","Winnipeg",2021-03-15,31,18039,368
"Manitoba","Winnipeg",2021-03-16,28,18067,369
"Manitoba","Winnipeg",2021-03-17,38,18105,370
"Manitoba","Winnipeg",2021-03-18,30,18135,371
"Manitoba","Winnipeg",2021-03-19,18,18153,372
"Manitoba","Winnipeg",2021-03-20,32,18185,373
"Manitoba","Winnipeg",2021-03-21,42,18227,374
"Manitoba","Winnipeg",2021-03-22,35,18262,375
"Manitoba","Winnipeg",2021-03-23,50,18312,376
"Manitoba","Winnipeg",2021-03-24,29,18341,377
"Manitoba","Winnipeg",2021-03-25,45,18386,378
"Manitoba","Winnipeg",2021-03-26,49,18435,379
"Manitoba","Winnipeg",2021-03-27,26,18461,380
"Manitoba","Winnipeg",2021-03-28,28,18489,381
"Manitoba","Winnipeg",2021-03-29,21,18510,382
"Manitoba","Winnipeg",2021-03-30,42,18552,383
"Manitoba","Winnipeg",2021-03-31,29,18581,384
"Manitoba","Winnipeg",2021-04-01,29,18610,385
"Manitoba","Winnipeg",2021-04-03,88,18698,387
"Manitoba","Winnipeg",2021-04-05,63,18761,389
"Manitoba","Winnipeg",2021-04-06,32,18793,390
"Manitoba","Winnipeg",2021-04-07,46,18839,391
"Manitoba","Winnipeg",2021-04-08,57,18896,392
"Manitoba","Winnipeg",2021-04-09,77,18973,393
"Manitoba","Winnipeg",2021-04-10,77,19050,394
"Manitoba","Winnipeg",2021-04-11,68,19118,395
"Manitoba","Winnipeg",2021-04-12,62,19180,396
"Manitoba","Winnipeg",2021-04-13,81,19261,397
"Manitoba","Winnipeg",2021-04-14,50,19311,398
"Manitoba","Winnipeg",2021-04-15,70,19381,399
"Manitoba","Winnipeg",2021-04-16,71,19452,400
"Manitoba","Winnipeg",2021-04-17,126,19578,401
"Manitoba","Winnipeg",2021-04-18,101,19679,402
"Manitoba","Winnipeg",2021-04-19,59,19738,403
"Manitoba","Winnipeg",2021-04-20,136,19874,404
"Manitoba","Winnipeg",2021-04-21,77,19951,405
"Manitoba","Winnipeg",2021-04-22,158,20109,406
"Manitoba","Winnipeg",2021-04-23,99,20208,407
"Manitoba","Winnipeg",2021-04-24,183,20391,408
"Manitoba","Winnipeg",2021-04-25,194,20585,409
"Manitoba","Winnipeg",2021-04-26,158,20743,410
"Manitoba","Winnipeg",2021-04-27,160,20903,411
"Manitoba","Winnipeg",2021-04-28,123,21026,412
"Manitoba","Winnipeg",2021-04-29,174,21200,413
"Manitoba","Winnipeg",2021-04-30,180,21380,414
"Manitoba","Winnipeg",2021-05-01,192,21572,415
"Manitoba","Winnipeg",2021-05-02,177,21749,416
"Manitoba","Winnipeg",2021-05-03,187,21936,417
"Manitoba","Winnipeg",2021-05-04,213,22149,418
"Manitoba","Winnipeg",2021-05-05,178,22327,419
"Manitoba","Winnipeg",2021-05-06,265,22592,420
"Manitoba","Winnipeg",2021-05-07,392,22984,421
"Manitoba","Winnipeg",2021-05-08,389,23373,422
"Manitoba","Winnipeg",2021-05-09,428,23801,423
"Manitoba","Winnipeg",2021-05-10,402,24203,424
"Manitoba","Winnipeg",2021-05-11,237,24440,425
"Manitoba","Winnipeg",2021-05-12,225,24665,426
"Manitoba","Winnipeg",2021-05-13,431,25096,427
"Manitoba","Winnipeg",2021-05-14,337,25433,428
"Manitoba","Winnipeg",2021-05-15,340,25773,429
"Manitoba","Winnipeg",2021-05-16,327,26100,430
"Manitoba","Winnipeg",2021-05-17,319,26419,431
"Manitoba","Winnipeg",2021-05-18,243,26662,432
"Manitoba","Winnipeg",2021-05-19,254,26916,433
"Manitoba","Winnipeg",2021-05-20,403,27319,434
"Manitoba","Winnipeg",2021-05-21,417,27736,435
"Manitoba","Winnipeg",2021-05-22,375,28111,436
"Manitoba","Winnipeg",2021-05-23,297,28408,437
"Manitoba","Winnipeg",2021-05-24,270,28678,438
"Manitoba","Winnipeg",2021-05-25,185,28863,439
"Manitoba","Winnipeg",2021-05-26,252,29115,440
"Manitoba","Winnipeg",2021-05-27,166,29281,441
"Manitoba","Winnipeg",2021-05-28,325,29606,442
"Manitoba","Winnipeg",2021-05-29,239,29845,443
"Manitoba","Winnipeg",2021-05-30,184,30029,444
"Manitoba","Winnipeg",2021-05-31,226,30255,445
"Manitoba","Winnipeg",2021-06-01,168,30423,446
"Manitoba","Winnipeg",2021-06-02,195,30618,447
"Manitoba","Winnipeg",2021-06-03,218,30836,448
"Manitoba","Winnipeg",2021-06-04,207,31043,449
"Manitoba","Winnipeg",2021-06-05,157,31200,450
"Manitoba","Winnipeg",2021-06-06,142,31342,451
"Manitoba","Winnipeg",2021-06-07,112,31454,452
"Manitoba","Winnipeg",2021-06-08,143,31597,453
"Manitoba","Winnipeg",2021-06-09,137,31734,454
"Manitoba","Winnipeg",2021-06-10,137,31871,455
"Manitoba","Winnipeg",2021-06-11,126,31997,456
"Manitoba","Winnipeg",2021-06-12,164,32161,457
"Manitoba","Winnipeg",2021-06-13,103,32264,458
"Manitoba","Winnipeg",2021-06-14,81,32345,459
"Manitoba","Winnipeg",2021-06-15,53,32398,460
"Manitoba","Winnipeg",2021-06-16,78,32476,461
"Manitoba","Winnipeg",2021-06-17,80,32556,462
"Manitoba","Winnipeg",2021-06-18,83,32639,463
"Manitoba","Winnipeg",2021-06-19,51,32690,464
"Manitoba","Winnipeg",2021-06-20,42,32732,465
"Manitoba","Winnipeg",2021-06-21,50,32782,466
"Manitoba","Winnipeg",2021-06-22,31,32813,467
"Manitoba","Winnipeg",2021-06-23,68,32881,468
"Manitoba","Winnipeg",2021-06-24,60,32941,469
"Manitoba","Winnipeg",2021-06-25,50,32991,470
"Manitoba","Winnipeg",2021-06-26,49,33040,471
"Manitoba","Winnipeg",2021-06-27,47,33087,472
"Manitoba","Winnipeg",2021-06-28,33,33120,473
"Manitoba","Winnipeg",2021-06-29,24,33144,474
"Manitoba","Winnipeg",2021-06-30,28,33172,475
"Manitoba","Winnipeg",2021-07-02,63,33235,477
"Manitoba","Winnipeg",2021-07-03,30,33265,478
"Manitoba","Winnipeg",2021-07-04,31,33296,479
"Manitoba","Winnipeg",2021-07-05,32,33328,480
"Manitoba","Winnipeg",2021-07-06,28,33356,481
"Manitoba","Winnipeg",2021-07-07,34,33390,482
"Manitoba","Winnipeg",2021-07-08,34,33424,483
"Manitoba","Winnipeg",2021-07-09,31,33455,484
"Manitoba","Winnipeg",2021-07-10,34,33489,485
"Manitoba","Winnipeg",2021-07-11,41,33530,486
"Manitoba","Winnipeg",2021-07-12,20,33550,487
"Manitoba","Winnipeg",2021-07-13,9,33559,488
"Manitoba","Winnipeg",2021-07-14,28,33587,489
"Manitoba","Winnipeg",2021-07-15,15,33602,490
"Manitoba","Winnipeg",2021-07-16,17,33619,491
"Manitoba","Winnipeg",2021-07-17,34,33653,492
"Manitoba","Winnipeg",2021-07-18,19,33672,493
"Manitoba","Winnipeg",2021-07-19,21,33693,494
"Manitoba","Winnipeg",2021-07-20,9,33702,495
"Manitoba","Winnipeg",2021-07-21,6,33708,496
"Manitoba","Winnipeg",2021-07-22,22,33730,497
"Manitoba","Winnipeg",2021-07-23,7,33737,498
"Manitoba","Winnipeg",2021-07-24,22,33759,499
"Manitoba","Winnipeg",2021-07-25,7,33766,500
"Manitoba","Winnipeg",2021-07-26,4,33770,501
"Manitoba","Winnipeg",2021-07-28,7,33776,503
"Manitoba","Winnipeg",2021-07-29,13,33789,504
"Manitoba","Winnipeg",2021-07-30,16,33805,505
"Manitoba","Winnipeg",2021-08-03,45,33850,509
"Manitoba","Winnipeg",2021-08-04,9,33859,510
"Manitoba","Winnipeg",2021-08-05,15,33874,511
"Manitoba","Winnipeg",2021-08-06,7,33881,512
"Manitoba","Winnipeg",2021-08-09,41,33922,515
"Manitoba","Winnipeg",2021-08-10,15,33937,516
"Manitoba","Winnipeg",2021-08-11,14,33951,517
"Manitoba","Winnipeg",2021-08-12,14,33965,518
"Manitoba","Winnipeg",2021-08-13,11,33976,519
"Manitoba","Winnipeg",2021-08-16,41,34017,522
"Manitoba","Winnipeg",2021-08-17,8,34025,523
"Manitoba","Winnipeg",2021-08-18,11,34036,524
"Manitoba","Winnipeg",2021-08-19,7,34043,525
"Manitoba","Winnipeg",2021-08-20,23,34066,526
"Manitoba","Winnipeg",2021-08-23,42,34108,529
"Manitoba","Winnipeg",2021-08-24,18,34126,530
"Manitoba","Winnipeg",2021-08-25,33,34159,531
"Manitoba","Winnipeg",2021-08-26,15,34174,532
"Manitoba","Winnipeg",2021-08-27,10,34184,533
"Manitoba","Winnipeg",2021-08-30,55,34239,536
"Manitoba","Winnipeg",2021-08-31,9,34248,537
"Manitoba","Winnipeg",2021-09-01,19,34267,538
"Manitoba","Winnipeg",2021-09-02,11,34278,539
"Manitoba","Winnipeg",2021-09-03,21,34299,540
"Manitoba","Winnipeg",2021-09-07,62,34361,544
"Manitoba","Winnipeg",2021-09-08,14,34375,545
"Manitoba","Winnipeg",2021-09-09,24,34399,546
"Manitoba","Winnipeg",2021-09-10,29,34428,547
"Manitoba","Winnipeg",2021-09-13,49,34477,550
"Manitoba","Winnipeg",2021-09-14,9,34486,551
"Manitoba","Winnipeg",2021-09-15,18,34504,552
"Manitoba","Winnipeg",2021-09-16,11,34515,553
"Manitoba","Winnipeg",2021-09-17,23,34538,554
"Manitoba","Winnipeg",2021-09-20,51,34589,557
"Manitoba","Winnipeg",2021-09-21,15,34604,558
"Manitoba","Winnipeg",2021-09-22,15,34619,559
"Manitoba","Winnipeg",2021-09-23,10,34629,560
"Manitoba","Winnipeg",2021-09-24,13,34642,561
"Manitoba","Winnipeg",2021-09-27,94,34736,564
"Manitoba","Winnipeg",2021-09-28,16,34752,565
"Manitoba","Winnipeg",2021-09-29,23,34775,566
"Manitoba","Winnipeg",2021-10-01,40,34815,568
"Manitoba","Winnipeg",2021-10-04,80,34895,571
"Manitoba","Winnipeg",2021-10-05,27,34922,572
"Manitoba","Winnipeg",2021-10-06,14,34936,573
"Manitoba","Winnipeg",2021-10-07,33,34969,574
"Manitoba","Winnipeg",2021-10-08,23,34992,575
"Manitoba","Winnipeg",2021-10-12,75,35067,579
"Manitoba","Winnipeg",2021-10-13,12,35079,580
"Manitoba","Winnipeg",2021-10-14,17,35096,581
"Manitoba","Winnipeg",2021-10-15,13,35109,582
"Manitoba","Winnipeg",2021-10-18,61,35170,585
"Manitoba","Winnipeg",2021-10-19,22,35192,586
"Manitoba","Winnipeg",2021-10-20,16,35208,587
"Manitoba","Winnipeg",2021-10-21,11,35219,588
"Manitoba","Winnipeg",2021-10-22,30,35249,589
"Manitoba","Winnipeg",2021-10-25,81,35330,592
"Manitoba","Winnipeg",2021-10-26,18,35348,593
"Manitoba","Winnipeg",2021-10-27,18,35366,594
"Manitoba","Winnipeg",2021-10-28,6,35372,595
"Manitoba","Winnipeg",2021-10-29,23,35395,596
"Manitoba","Winnipeg",2021-11-01,69,35464,599
"Manitoba","Winnipeg",2021-11-02,5,35469,600
"Manitoba","Winnipeg",2021-11-03,34,35503,601
"Manitoba","Winnipeg",2021-11-04,28,35531,602
"Manitoba","Winnipeg",2021-11-05,31,35562,603
"Manitoba","Winnipeg",2021-11-08,145,35707,606
"Manitoba","Winnipeg",2021-11-09,62,35769,607
"Manitoba","Winnipeg",2021-11-10,29,35798,608
"Manitoba","Winnipeg",2021-11-12,71,35869,610
"Manitoba","Winnipeg",2021-11-15,141,36010,613
"Manitoba","Winnipeg",2021-11-16,28,36038,614
"Manitoba","Winnipeg",2021-11-17,38,36076,615
"Manitoba","Winnipeg",2021-11-18,41,36117,616
"Manitoba","Winnipeg",2021-11-19,57,36174,617
"Manitoba","Winnipeg",2021-11-22,114,36288,620
"Manitoba","Winnipeg",2021-11-23,31,36319,621
"Manitoba","Winnipeg",2021-11-24,28,36347,622
"Manitoba","Winnipeg",2021-11-25,39,36386,623
"Manitoba","Winnipeg",2021-11-26,44,36430,624
"Manitoba","Winnipeg",2021-11-29,94,36524,627
"Manitoba","Winnipeg",2021-11-30,32,36556,628
"Manitoba","Winnipeg",2021-12-01,31,36587,629
"Manitoba","Winnipeg",2021-12-02,45,36632,630
"Manitoba","Winnipeg",2021-12-03,39,36671,631
"Manitoba","Winnipeg",2021-12-06,185,36856,634
"Manitoba","Winnipeg",2021-12-07,29,36885,635
"Manitoba","Winnipeg",2021-12-08,50,36935,636
"Manitoba","Winnipeg",2021-12-09,60,36995,637
"Manitoba","Winnipeg",2021-12-10,64,37059,638
"Manitoba","Winnipeg",2021-12-13,151,37210,641
"Manitoba","Winnipeg",2021-12-14,75,37285,642
"Manitoba","Winnipeg",2021-12-15,74,37359,643
"Manitoba","Winnipeg",2021-12-16,105,37464,644
"Manitoba","Winnipeg",2021-12-17,104,37568,645
"Manitoba","Winnipeg",2021-12-20,506,38074,648
"Manitoba","Winnipeg",2021-12-21,199,38273,649
"Manitoba","Winnipeg",2021-12-22,258,38531,650
"Manitoba","Winnipeg",2021-12-23,355,38886,651
"Manitoba","Winnipeg",2021-12-24,529,39415,652
"Manitoba","Winnipeg",2021-12-27,1470,40885,655
"Manitoba","Winnipeg",2021-12-28,519,41404,656
"Manitoba","Winnipeg",2021-12-29,675,42079,657
"Manitoba","Winnipeg",2021-12-30,769,42848,658
"Manitoba","Winnipeg",2021-12-31,857,43705,659
"Manitoba","Winnipeg",2022-01-03,3645,47350,662
"Manitoba","Winnipeg",2022-01-04,1352,48702,663
"Manitoba","Winnipeg",2022-01-05,1317,50019,664
"Manitoba","Winnipeg",2022-01-06,1493,51512,665
"Manitoba","Winnipeg",2022-01-07,2162,53674,666
"Manitoba","Winnipeg",2022-01-10,4691,58365,669
"Manitoba","Winnipeg",2022-01-11,1274,59639,670
"Manitoba","Winnipeg",2022-01-12,809,60448,671
"Manitoba","Winnipeg",2022-01-13,659,61107,672
"Manitoba","Winnipeg",2022-01-14,506,61613,673
"Manitoba","Winnipeg",2022-01-17,1346,62959,676
"Manitoba","Winnipeg",2022-01-18,456,63415,677
"Manitoba","Winnipeg",2022-01-19,558,63973,678
"Manitoba","Winnipeg",2022-01-20,404,64377,679
"Manitoba","Winnipeg",2022-01-21,443,64820,680
"Manitoba","Winnipeg",2022-01-24,1036,65856,683
"Manitoba","Winnipeg",2022-01-25,363,66219,684
"Manitoba","Winnipeg",2022-01-26,286,66505,685
"Manitoba","Winnipeg",2022-01-27,295,66800,686
"Manitoba","Winnipeg",2022-01-28,423,67223,687
"Manitoba","Winnipeg",2022-01-31,789,68012,690
"Manitoba","Winnipeg",2022-02-01,227,68239,691
"Manitoba","Winnipeg",2022-02-02,281,68520,692
"Manitoba","Winnipeg",2022-02-03,201,68721,693
"Manitoba","Winnipeg",2022-02-04,256,68977,694
"Manitoba","Winnipeg",2022-02-07,449,69426,697
"Manitoba","Winnipeg",2022-02-08,160,69586,698
"Manitoba","Winnipeg",2022-02-09,181,69767,699
"Manitoba","Winnipeg",2022-02-10,168,69935,700
"Manitoba","Winnipeg",2022-02-11,188,70123,701
"Manitoba","Winnipeg",2022-02-14,332,70455,704
"Manitoba","Winnipeg",2022-02-15,113,70568,705
"Manitoba","Winnipeg",2022-02-16,113,70681,706
"Manitoba","Winnipeg",2022-02-17,105,70786,707
"Manitoba","Winnipeg",2022-02-18,134,70920,708
"Manitoba","Winnipeg",2022-02-22,225,71145,712
"Manitoba","Winnipeg",2022-02-23,68,71213,713
"Manitoba","Winnipeg",2022-02-24,92,71305,714
"Manitoba","Winnipeg",2022-02-25,104,71409,715
"Manitoba","Winnipeg",2022-02-28,172,71581,718
"Manitoba","Winnipeg",2022-03-01,65,71646,719
"Manitoba","Winnipeg",2022-03-02,52,71698,720
"Manitoba","Winnipeg",2022-03-03,58,71756,721
"Manitoba","Winnipeg",2022-03-04,66,71822,722
"Manitoba","Winnipeg",2022-03-07,174,71996,725
"Manitoba","Winnipeg",2022-03-08,51,72047,726
"Manitoba","Winnipeg",2022-03-09,78,72125,727
"Manitoba","Winnipeg",2022-03-10,100,72225,728
"Manitoba","Winnipeg",2022-03-11,62,72287,729
"Manitoba","Winnipeg",2022-03-14,219,72506,732
"Manitoba","Winnipeg",2022-03-15,56,72562,733
"Manitoba","Winnipeg",2022-03-16,127,72689,734
"Manitoba","Winnipeg",2022-03-17,88,72777,735
"Manitoba","Winnipeg",2022-03-18,87,72864,736
"Manitoba","Winnipeg",2022-03-21,150,73014,739
"Manitoba","Winnipeg",2022-03-22,46,73060,740
"Manitoba","Winnipeg",2022-03-23,75,73135,741
"Manitoba","Winnipeg",2022-03-24,94,73229,742
"Manitoba","Winnipeg",2022-03-25,100,73329,743
"Manitoba","Winnipeg",2022-03-27,144,73473,745
"Manitoba","Winnipeg",2022-04-03,669,74142,752
"Manitoba","Winnipeg",2022-04-10,833,74975,759
"Manitoba","Winnipeg",2022-04-17,591,75566,766
"Manitoba","Winnipeg",2022-04-24,760,76326,773
